 ##################
 #o              ##
 # # # # ##########
 # # # #         ##
 # ######### # # ##
 #         # # # ##
 # # ##### # ######
 # #   # # #     ##
 # # # # ##########
 # # #           ##
 # ##### # # ######
 #     # # #     ##
 # # ##### ##### ##
 # #     #     # ##
 # # # # # ########
 # # # # #      E##
 ##################
 ##################
